13 13
4 4 4 4 4 4 4 4 4 4 4 4 0
4 0 3 6 4 9 11 17 4 4 4 4 0
4 1 4 7 4 13 13 13 13 4 4 4 0
4 2 5 8 5 5 5 5 5 5 5 5 3
4 7 0 3 3 3 3 3 6 3 3 3 3
4 7 1 13 17 11 17 4 7 1 13 4 0
4 7 1 17 11 9 9 11 7 1 13 4 0
4 7 1 11 9 9 9 11 7 1 4 4 0
4 7 1 13 11 17 17 13 7 1 4 4 0
4 7 2 5 5 5 5 5 8 1 4 4 0
4 13 3 3 3 3 3 3 3 1 4 4 0
4 4 4 4 4 4 4 4 4 4 4 4 0
4 4 4 4 4 4 4 4 4 4 4 4 0