13 13
4 4 4 4 4 4 4 4 4 4 4 4 4
4 4 4 4 4 4 4 4 4 4 4 4 4
4 4 4 4 4 4 4 4 4 4 4 4 4
4 9 7 7 7 7 7 7 7 10 4 4 4
4 5 0 1 1 1 1 1 2 3 4 4 4
4 5 3 4 4 17 16 4 5 3 4 4 4
4 5 3 4 16 15 15 16 5 3 4 4 4
4 5 3 16 15 15 15 17 5 3 4 4 4
4 5 3 4 18 15 15 15 5 3 4 4 4
4 5 3 4 4 16 16 4 5 3 4 4 4
4 5 6 7 7 7 7 7 8 3 4 4 4
4 11 1 1 1 1 1 1 1 12 4 4 4
4 4 4 4 4 4 4 4 4 4 4 4 4