13 13
4 4 4 4 4 4 4 4 4 4 4 4 0
4 0 3 6 4 9 11 17 4 4 4 4 0
4 1 4 7 4 9 11 17 4 4 4 4 0
4 2 5 8 4 9 11 17 4 4 4 4 0
4 4 4 4 4 4 4 4 4 4 4 4 0
4 4 4 4 4 4 4 4 4 4 4 4 0
4 4 4 4 4 4 4 4 4 4 4 4 0
4 4 4 4 4 4 4 4 13 4 4 4 0
4 4 13 13 13 13 13 13 13 4 4 4 0
4 4 4 4 4 4 4 4 4 4 4 4 0
4 4 4 4 4 4 4 4 4 4 4 4 0
4 4 4 4 4 4 4 4 4 4 4 4 0
4 4 4 4 4 4 4 4 4 4 4 4 0