50 50
20 21 21 21 21 21 21 21 21 21 21 21 21 21 21 22 4 5 19 3 18 69 70 65 66 67 70 71 18 5 19 3 4 20 21 21 21 21 21 21 21 21 21 21 21 21 21 21 21 22
23 24 24 24 24 83 83 24 24 24 24 24 24 24 24 25 84 5 19 3 18 20 22 5 19 3 20 22 18 5 19 3 84 23 24 24 24 24 24 24 24 24 24 24 24 24 24 24 24 25
23 24 24 83 83 24 24 83 24 24 24 24 24 24 24 25 84 5 19 3 18 23 25 5 19 3 23 25 18 5 19 3 84 23 24 83 83 83 24 24 83 24 83 24 83 24 24 83 24 25
23 83 83 24 24 24 24 24 83 83 83 24 24 24 24 25 4 5 19 3 18 23 25 5 19 3 23 25 18 5 19 3 4 23 24 24 24 24 24 24 24 24 24 24 83 83 24 24 24 25
23 24 24 24 83 24 24 24 24 24 24 24 83 24 24 25 84 5 19 6 10 26 28 5 19 3 26 28 9 8 19 3 84 23 24 83 24 24 83 24 24 83 24 24 24 24 24 24 24 25
23 24 83 24 24 83 83 24 24 83 24 24 24 24 24 25 4 5 19 19 6 10 37 5 19 3 37 9 8 19 19 3 4 23 24 83 83 83 24 24 83 24 24 83 24 24 24 83 24 25
23 83 83 24 83 24 24 24 24 24 24 83 83 24 24 31 22 11 2 19 19 6 7 8 19 6 7 8 19 19 0 12 20 32 24 83 24 83 24 24 83 24 24 24 24 83 24 24 24 25
23 24 24 24 24 29 27 27 27 30 24 24 24 24 24 24 25 84 11 2 19 19 19 19 19 19 19 19 19 0 12 84 23 83 83 24 24 24 24 29 27 27 27 30 24 24 83 24 24 25
23 24 83 24 24 25 4 4 4 23 24 24 24 24 24 24 31 22 84 11 1 2 19 19 19 19 19 0 1 12 84 20 32 24 24 24 24 24 24 25 4 4 4 23 24 24 24 24 24 25
23 24 24 24 83 25 4 84 4 60 61 64 61 64 61 64 61 63 4 15 48 11 1 2 19 0 1 12 48 15 4 60 61 64 61 64 61 64 61 63 4 84 4 23 83 83 24 24 24 25
23 83 24 24 24 25 4 4 4 23 62 24 62 24 62 24 62 25 15 37 15 17 4 5 19 3 4 17 15 37 16 23 62 24 62 24 62 24 62 25 4 4 4 23 24 24 24 83 24 25
23 24 24 83 24 31 21 21 21 32 83 83 24 24 83 24 24 25 16 15 16 15 17 5 19 3 17 15 16 15 16 23 83 83 24 24 24 24 24 31 21 21 21 32 24 24 83 24 24 25
23 24 24 24 24 24 24 24 83 24 24 24 24 83 83 24 24 25 48 17 15 16 37 5 19 3 37 16 15 17 48 23 24 24 24 24 24 83 24 24 24 24 24 24 24 24 24 83 24 25
23 24 83 83 83 24 24 83 83 24 24 24 24 24 83 24 83 25 15 16 17 48 15 5 19 3 16 48 17 15 16 23 24 24 83 24 83 83 83 24 24 24 24 83 83 83 24 24 24 25
23 24 24 83 24 24 24 24 83 83 24 24 83 83 24 24 83 25 15 18 15 16 16 5 19 3 15 16 15 18 16 23 24 83 24 24 24 24 24 24 24 24 83 24 83 24 24 24 83 25
23 24 24 24 24 24 83 24 24 24 24 24 24 24 24 24 24 25 4 16 37 18 15 5 19 3 15 18 37 16 4 23 24 24 24 83 24 24 83 83 24 24 24 24 24 24 24 24 24 25
26 27 27 27 30 24 24 83 24 24 83 83 24 24 83 24 29 28 4 9 7 7 7 8 19 6 7 7 7 10 4 26 30 24 83 83 24 24 24 83 24 83 24 24 29 27 27 27 27 28
15 16 4 4 26 30 24 24 24 24 83 24 24 83 24 29 28 84 9 8 19 19 19 19 19 19 19 19 19 6 10 4 26 30 24 24 24 24 24 24 24 83 24 29 28 4 4 4 16 16
16 15 15 18 4 26 27 27 27 27 27 27 27 27 27 28 84 9 8 19 19 0 1 1 1 1 1 2 19 19 6 10 4 26 27 27 27 27 27 27 27 27 27 28 4 16 17 15 18 16
15 17 15 16 15 15 15 15 15 84 15 15 15 17 15 4 9 8 19 19 0 12 16 15 17 15 16 11 2 19 19 6 10 4 15 18 15 15 15 15 16 16 16 84 15 84 16 15 15 18
15 18 15 15 17 15 17 15 15 18 17 84 15 15 16 15 5 19 19 0 12 37 17 84 37 17 15 18 11 2 19 19 3 15 16 84 18 17 17 84 15 15 15 16 15 17 15 17 84 15
15 15 16 84 15 15 16 84 15 15 15 15 16 18 17 15 5 19 0 12 15 17 15 18 15 16 84 84 15 11 2 19 3 15 17 17 15 16 84 15 18 17 16 17 84 15 18 15 15 16
18 15 15 15 84 18 15 15 17 15 9 7 7 7 7 7 8 19 3 16 38 16 15 44 45 17 38 18 18 15 5 19 6 7 7 7 7 7 7 10 16 15 15 16 18 18 16 84 17 15
15 17 16 4 9 7 7 7 7 7 8 19 19 19 19 19 19 19 3 15 39 17 16 46 47 15 39 15 16 16 5 19 19 19 19 19 19 19 19 6 7 7 7 7 7 10 4 16 15 17
7 7 7 7 8 19 19 19 19 19 19 19 0 1 1 1 2 19 3 15 18 84 15 15 17 15 15 18 16 15 5 19 0 1 1 1 1 2 19 19 19 19 19 19 19 6 7 7 7 7
19 19 19 19 19 19 0 1 1 1 1 1 12 84 16 17 5 19 6 10 15 17 37 84 16 18 15 84 37 9 8 19 3 15 15 15 15 11 1 1 1 1 1 2 19 19 19 19 19 19
1 1 1 1 1 1 12 4 15 18 16 15 84 17 37 15 5 19 19 6 10 16 15 18 37 15 15 15 9 8 19 19 3 15 16 84 15 37 15 15 15 16 15 11 1 1 1 1 1 1
15 84 18 16 18 16 84 18 48 15 17 16 17 15 15 15 11 2 19 19 6 10 15 16 16 15 18 9 8 19 19 0 12 15 18 15 15 16 15 18 16 15 18 15 16 15 15 16 15 15
18 16 37 17 84 17 16 37 17 84 15 18 15 15 17 15 16 11 2 19 19 6 7 7 7 7 7 8 19 19 0 12 15 16 15 16 17 15 48 15 15 84 17 48 15 18 16 15 17 15
15 18 84 48 15 15 18 15 15 84 17 15 17 15 37 16 84 15 11 2 19 19 19 19 19 19 19 19 19 0 12 15 15 84 16 37 15 15 84 16 15 15 15 15 84 15 15 16 15 15
37 17 16 18 15 17 48 17 18 15 18 15 18 48 17 15 48 16 15 11 1 1 1 2 19 0 1 1 1 12 15 84 15 15 17 15 48 15 18 15 17 15 84 37 17 15 84 48 84 16
18 15 37 17 16 15 16 15 49 50 4 37 15 18 15 16 17 15 84 16 37 15 15 5 19 3 15 15 15 15 15 16 15 48 15 15 18 16 15 16 15 16 16 15 16 16 15 37 15 15
15 15 18 48 15 17 15 4 51 52 53 16 15 17 16 15 16 15 18 15 15 17 37 5 19 3 15 16 16 15 16 15 18 15 15 84 15 17 15 15 15 18 15 17 15 15 16 15 16 15
15 17 18 16 84 15 38 4 54 55 56 38 16 15 37 84 15 17 18 17 48 84 16 5 19 3 15 15 84 17 37 48 15 15 17 15 84 15 15 37 15 15 84 15 84 48 15 18 15 15
18 37 15 18 16 15 39 4 57 58 59 39 16 15 16 17 15 48 15 15 15 18 15 5 19 3 15 15 15 15 16 15 84 15 15 15 15 15 16 15 15 16 15 15 15 15 15 15 15 15
7 7 7 7 7 7 7 7 7 7 7 7 7 7 7 7 7 7 7 7 7 7 7 8 19 6 7 7 7 7 7 7 7 7 7 7 7 7 7 7 7 7 7 7 7 7 7 7 7 7
19 19 19 19 19 19 19 19 19 19 19 19 19 19 19 19 19 19 19 19 19 19 19 19 19 19 19 19 19 19 19 19 19 19 19 19 19 19 19 19 19 19 19 19 19 19 19 19 19 19
1 1 1 1 1 1 1 1 1 1 1 1 1 1 1 1 1 1 1 1 1 1 1 2 19 0 1 1 1 1 1 1 1 1 1 1 1 1 1 1 1 1 1 1 1 1 1 1 1 1
4 4 4 4 4 79 76 76 76 76 76 76 76 80 4 4 4 4 4 4 84 4 4 5 19 3 4 4 4 84 4 4 4 4 84 79 76 76 76 76 76 76 76 80 4 4 4 4 84 4
4 84 84 4 4 74 15 15 17 16 15 16 17 75 84 84 4 84 4 84 4 4 4 5 19 3 4 84 84 4 84 4 84 4 4 74 18 17 16 15 18 15 15 75 4 84 84 4 84 4
4 4 4 84 4 74 18 15 4 84 4 18 15 75 4 4 84 4 84 84 4 84 4 5 19 3 4 84 84 84 84 84 4 84 4 74 15 16 4 84 4 15 16 75 4 4 84 4 84 4
4 84 84 4 4 74 16 18 4 4 4 15 16 75 4 4 84 4 4 84 4 84 4 5 19 3 4 4 84 4 84 84 84 4 4 74 16 18 4 4 4 15 17 75 4 84 84 84 84 4
4 4 4 84 4 74 15 37 4 4 4 37 17 75 4 84 4 84 4 4 84 4 4 5 19 3 4 4 4 4 4 4 84 84 4 74 15 37 4 4 4 37 15 75 4 4 84 4 84 4
84 4 4 4 4 81 72 72 72 77 72 72 72 82 84 4 4 4 4 9 7 7 7 8 19 6 7 7 7 10 4 84 4 4 4 81 72 72 72 77 72 72 72 82 4 84 84 84 4 84
4 4 4 84 4 73 73 73 73 78 73 73 73 73 4 4 9 7 7 8 19 19 19 19 19 19 19 19 19 6 7 7 10 4 84 73 73 73 73 78 73 73 73 73 4 4 4 4 4 4
4 4 84 4 84 4 4 84 4 4 84 4 84 4 9 7 8 19 19 19 19 0 1 1 1 1 1 2 19 19 19 19 6 7 10 4 84 84 4 4 4 84 4 84 4 84 4 4 84 4
7 7 7 7 7 7 7 7 7 7 7 7 7 7 8 19 19 19 0 1 1 12 15 15 84 15 15 11 1 1 2 19 19 19 6 7 7 7 7 7 7 7 7 7 7 7 7 7 7 7
19 19 19 19 19 19 19 19 19 19 19 19 19 19 19 19 0 1 12 15 15 15 18 48 15 84 17 15 15 15 11 1 2 19 19 19 19 19 19 19 19 19 19 19 19 19 19 19 19 19
1 1 1 1 1 1 1 1 1 1 1 1 1 1 1 1 12 84 15 48 17 15 15 15 15 17 48 37 15 84 15 15 11 1 1 1 1 1 1 1 1 1 1 1 1 1 1 1 1 1
15 48 17 18 37 84 17 15 15 18 15 37 17 15 18 15 15 15 17 15 15 15 15 37 84 15 18 15 15 17 15 48 15 84 18 15 15 37 18 15 84 17 15 18 17 37 17 84 15 48