13 13
4 4 15 15 16 16 17 16 16 17 17 4 4
15 20 21 21 21 21 21 21 21 21 22 18 15
17 23 24 24 24 24 24 24 24 24 25 18 15
4 23 24 24 24 24 24 24 24 24 25 16 15
20 32 24 24 29 27 27 27 30 24 25 16 4
26 27 27 27 28 18 18 16 26 27 28 4 9
15 15 17 4 4 9 7 7 7 7 7 7 8
17 17 9 7 7 8 19 19 19 19 19 19 19
7 7 8 19 19 19 0 1 1 1 1 1 12
19 19 19 19 0 1 12 4 16 18 15 15 17
1 1 1 1 12 4 16 15 15 17 15 15 16
4 17 17 4 4 18 16 18 15 15 17 15 16
15 16 15 16 18 15 15 16 15 16 15 15 16