14 16
7 10 10 10 6 4 2 2 5 7 10 10 10 6
4 1 2 3 5 4 1 2 5 4 1 2 3 5
4 2 2 2 5 4 2 3 5 4 2 2 2 5
4 1 2 3 5 4 1 2 5 4 1 2 3 5
4 2 2 2 5 4 2 3 5 4 2 2 2 5
4 2 2 2 5 4 1 2 5 4 2 2 2 5
4 2 2 2 5 4 2 3 5 4 2 2 2 5
4 2 2 2 5 4 1 2 5 4 2 2 2 5
4 2 2 2 13 14 2 3 13 14 2 2 2 5
4 2 2 2 2 2 2 2 2 2 2 2 2 5
4 1 2 2 2 2 2 2 2 2 2 2 3 5
4 2 2 2 2 2 2 2 2 2 2 2 2 5
4 1 2 2 2 2 2 2 2 2 2 2 3 5
4 2 2 2 2 2 2 2 2 2 2 2 2 5
4 1 2 2 2 2 2 2 2 2 2 2 3 5
8 11 11 11 11 11 2 2 11 11 11 11 11 9