15 16
20 20 20 20 20 10 20 20 11 20 20 20 20 20 20
20 20 20 20 20 10 0 0 11 20 20 20 20 20 20
20 20 20 20 20 10 0 0 11 20 20 20 20 20 20
20 20 20 20 20 10 0 0 11 20 20 20 20 20 20
20 20 20 20 20 10 0 0 11 20 20 20 20 20 20
20 20 20 20 20 10 0 0 11 20 20 20 20 20 20
20 20 20 20 20 10 0 0 11 20 20 20 20 20 20
20 20 20 20 20 10 0 0 11 20 20 20 20 20 20
20 20 20 20 20 10 0 0 11 20 20 20 20 20 20
20 20 20 20 20 10 0 0 11 20 20 20 20 20 20
20 20 20 20 20 10 0 0 11 20 20 20 20 20 20
20 20 20 20 20 10 0 0 11 20 20 20 20 20 20
20 20 20 20 20 10 0 0 11 20 20 20 20 20 20
20 20 20 20 20 20 20 20 20 20 20 20 20 20 20
20 20 20 20 20 20 20 20 20 20 20 20 20 20 20
20 20 20 20 20 20 20 20 20 20 20 20 20 20 20