15 16
20 20 20 20 20 10 25 26 11 20 20 20 20 20 20
20 20 20 20 20 10 0 0 11 20 20 20 20 20 20
20 20 20 20 20 10 8 0 11 20 20 20 20 20 20
20 20 20 20 20 10 0 0 11 20 20 20 20 20 20
20 20 20 20 20 10 0 0 11 20 20 20 20 20 20
20 20 20 20 20 10 0 0 11 20 20 20 20 20 20
20 20 20 20 20 10 0 9 11 20 20 20 20 20 20
20 20 20 20 20 10 0 0 11 20 20 20 20 20 20
20 20 20 20 20 10 0 0 11 20 20 20 20 20 20
20 20 20 20 20 10 0 0 11 20 20 20 20 20 20
20 20 20 20 20 10 8 0 11 20 20 20 20 20 20
20 20 20 20 20 10 0 0 11 20 20 20 20 20 20
20 20 20 20 20 10 0 0 11 20 20 20 20 20 20
20 20 20 20 20 10 0 0 11 20 20 20 20 20 20
20 20 20 20 20 10 8 9 11 20 20 20 20 20 20
20 20 20 20 20 10 25 26 11 20 20 20 20 20 20