13 12
6 9 9 9 9 9 9 9 9 9 9 9 5
3 1 16 0 0 0 0 0 0 0 16 2 4
3 1 17 0 0 0 0 0 0 0 17 2 4
7 10 13 18 0 0 0 0 0 14 13 10 8
6 9 9 12 0 0 0 0 0 11 9 9 5
3 1 16 0 0 0 0 0 0 0 16 2 4
3 1 17 0 0 0 0 0 0 0 17 2 4
7 10 13 18 0 0 0 0 0 14 13 10 8
6 9 9 12 0 0 0 0 0 11 9 9 5
3 1 16 0 0 0 0 0 0 0 16 2 4
3 1 17 0 0 0 0 0 0 0 17 2 4
7 10 13 10 10 10 10 10 10 10 13 10 8