15 16
13 16 16 16 12 13 16 16 16 12 13 16 16 16 12
10 0 0 9 11 10 8 5 9 11 10 8 0 0 11
10 8 4 0 20 21 8 0 9 20 21 0 6 9 11
10 0 0 0 0 0 4 0 18 0 0 0 0 0 11
10 8 3 0 6 0 0 0 0 0 3 0 7 9 11
10 0 0 0 0 0 4 0 18 0 0 0 0 0 11
10 8 6 0 3 0 0 0 0 0 6 0 3 9 11
10 0 0 0 0 0 4 0 18 0 0 0 0 0 11
10 8 7 0 6 0 0 0 0 0 7 0 6 9 11
10 0 0 0 0 0 4 0 18 0 0 0 0 0 11
10 8 6 0 3 0 0 0 0 0 3 0 6 9 11
10 0 0 0 0 0 4 0 18 0 0 0 0 0 11
10 8 3 0 6 0 0 0 0 0 6 0 3 9 11
10 0 0 0 0 0 4 0 18 0 0 0 0 0 11
10 8 6 0 7 0 2 2 2 0 7 0 6 9 11
14 17 17 17 17 17 1 1 1 17 17 17 17 17 15