16 18
13 16 16 16 16 16 16 25 26 16 16 16 16 16 16 12
10 8 0 0 7 0 0 0 0 0 0 7 0 0 9 11
10 8 0 0 0 0 0 0 0 0 0 0 0 0 9 11
10 27 27 27 27 27 27 27 27 27 27 27 27 27 27 11
10 35 35 33 28 34 35 35 35 35 35 35 35 35 35 11
10 35 35 29 0 30 35 35 35 35 35 35 35 35 35 11
10 35 35 32 27 31 35 35 35 35 33 28 34 35 35 11
10 35 35 35 35 35 35 35 35 35 29 0 30 35 35 11
10 35 35 35 35 35 35 35 35 35 32 27 31 35 35 11
10 35 35 33 28 34 35 35 35 35 35 35 35 35 35 11
10 35 35 29 0 30 35 35 35 35 35 35 35 35 35 11
10 35 35 32 27 31 35 35 35 35 33 28 34 35 35 11
10 35 35 35 35 35 35 35 35 35 29 0 30 35 35 11
10 35 35 35 35 35 35 35 35 35 32 27 31 35 35 11
10 28 28 28 28 28 28 28 28 28 28 28 28 28 28 11
10 8 0 0 0 0 0 0 0 0 0 0 0 0 9 11
10 8 0 0 7 0 0 0 0 0 0 7 0 0 9 11
14 17 17 17 17 17 17 25 26 17 17 17 17 17 17 15