12 11
20 20 20 20 10 25 26 11 20 20 20 20
13 16 16 12 10 8 9 11 13 16 16 12
10 0 0 11 10 8 9 11 10 0 0 11
10 0 0 11 10 8 9 11 10 0 0 11
10 0 0 11 10 8 9 11 10 0 0 11
10 0 0 11 10 8 9 11 10 0 0 11
10 0 0 11 10 8 9 11 10 0 0 11
10 0 0 21 22 8 9 21 22 0 0 11
10 8 0 0 0 0 0 0 0 0 9 11
10 8 0 0 0 0 0 0 0 0 9 11
14 17 17 17 17 17 17 17 17 17 17 15