17 12
4 4 4 4 4 4 17 15 15 20 21 21 21 21 21 21 21
4 4 4 4 4 4 15 15 18 23 24 24 24 24 24 24 24
15 16 4 4 4 4 4 15 15 23 24 24 24 29 27 30 24
17 15 4 4 4 4 4 4 4 60 61 64 61 63 35 23 24
16 15 4 4 4 4 4 4 16 23 62 24 62 31 21 32 24
15 18 4 4 4 4 4 4 18 23 24 24 24 24 24 24 24
49 50 4 4 4 4 4 4 15 26 27 27 27 27 27 27 27
51 52 53 4 4 4 4 16 15 17 37 16 16 15 37 18 15
54 55 56 17 15 16 15 15 17 16 15 17 44 45 17 15 18
57 58 59 16 15 17 15 16 15 18 48 15 46 47 16 15 48
7 7 7 7 7 7 10 17 15 15 17 37 16 15 15 17 15
19 19 19 19 19 19 3 15 16 48 15 18 15 16 17 37 16